OOOOOOOOOOOOOOOOO
OXO O      O    O
O . O  OOO OO O O
O O O  . O O  O O
O O O  O O O OO.O
O O OOOO O    O U
O . .  O OOO OO.O
O O O  O  OO OO O
O O OO OO  O OO O
O   O      O    O
OOOOOOOOOOOOOOOOO
